1111111111
1P000000E1
1001101111
10001C1001
101C111001
1001100001
1C00111001
1000C00001
1E0100CCE1
1111111111