111111111111111111111111
1E000000C000000110010111
100101111100000110C10111
10010000C0000C0110000111
1001000000000C0110000111
10001111101100000C100101
1001000000000C0110000111
100011111C1100000C100001
1001011111000000C0000111
101011111000001110000111
10010000C000000110000111
1001000000000C011000P111
111111111111111111111111