1111111111111111111111111111111111
10000000000000E00000E0000000000011
1010010100100000101001000000010101
1010010010101010001001000000010101
1P0000000E00E0000000000000000000C1
1111111111111111111111111111111111