111111111111111111111111
1E00M0M0C000000110010111
100101111100M00110C10111
1001M000C000MC0110000111
1000000000M00C011000M111
10001111101100000C1001M1
1001000000M00C0110000111
100011111C1100000C100001
10M1011111000000C0000111
101011111000001110000111
10010000C000000110000111
1001000M0000MC011000P111
111111111111111111111111