111111111111111111111
1E000000C000110010111
100101111000110C10111
10110000C0C0110000111
1001000000C0110000111
10001111100000C100101
1001000000C0110000111
100011111C10001100001
1001011111000C0000111
101011111001110000111
10000C000000110000111
1001000000C011000P111
111111111111111111111