1111111111
1P00000001
1001101111
10001C1001
1010111001
1001100001
1000111001
100000E001
1000000001
1111111111