1111111111
1P00000ME1
10M1100M01
10001C0001
101C111MM1
10M1100001
1C00000001
10000M0MM1
10000MCCC1
1111111111