1111111111
10000000E1
1001101001
10001C10P1
101C111001
1111111111