1111111111
10000000E1
1001101111
10001C1001
101C111001
1001100001
1000111001
10000P0001
10000000C1
1111111111